MMMMMMMMMMMMMMMMMMMMMMMMMMMMMMMMMMMMMMMMMMMMRRMMMMMMMMMMMMMMMMMMMMMMMMMMMMMMMMMM
MMMMMMMMMMMMMMMMMMMMMMMMMMMMMMMMMMMMMMMMMMMMRMMMMMMMMMMMMMMMMMMMMMMMMMMMMMMMMMMM
MMMMMMMMMMMMMMMMMMMMMMMMMMMMMMMMMMMMMMMMMMMRRMMMMMMMMMMMMMMMMMMMMMMMMMMMMMMMMMMM
MMMMMMMMMMMMMMMMMMMMMMMMMMMMMMMMMMMMMMMMMMRRMMMMMMMMMMMMMMMMMMMMMMMMMMMMMMMMMMMM
MMMMMMMMMMMMMMMMMMMMMMMMMMMMMMMMMRRRRRRRRRRMMMMMMMMMMMMMRRRRRRRRRMMMMMMMMMMMMMMM
MMMMMMMMMMMMMMMMMMMMMMMRRRRRRRRRRMMMMMMMMMRRMMMMMMMMRRRRRMMMMMMMRRRRMMMMMMMMMMMM
MMMMMMMMMMMMMMMMMMMMRRRRMMMMMMMMMMMMMMMMMMMRMMMMRRRRRMMMMMMMMMMMMMMRRRMMMMMMMMMM
MMMMMMMMMMMMMMMMMRRRRMMMMMMMMMMMMMMMMMMMMMMRRRRRRMMMMMMMMMMMMMMMMMMMMRRMMMMMMMMM
MMMMMMMMMMMMMMMMRRMMMMMMMMMMMMMMMMMMMMMMMMMMMMMMMMMMMMMMMMMMMMMMMMMMMMRMMMMMMRRR
MMMRRRRRRRRRRRRRRRRRRRRRRRRRRRMMMMMMMMMMMMMMMMMMMMMMMMMMMMMMMMMMMMMMMMRRMRRRRRMM
RRRRMMMMMMMMMMMMMMMMMMMMMMMMMRRRRMMMMMMMMMMMMMMMMMMMMMMMMMMMMMMMMMMMMRRRRRMMMMMM
MMMMMMMMMMMMMMMMMMMMMMMMMMMMMMMMRRRMMMMMMMMMMMMMMMMMMMMMMMMMMMMRRRRRRRMMMMMMMMMM
MMMMMMMMMMMMMMMMMMMMMMMMMMMMMMMMMMRRMMMMMMMMMMMMMMMMMMMMMMMMRRRRMMMMMMMMMMMMMMMM
MMMMMMMMMMMMMMMMMMMMMMMMMMMMMMMMMMMRMMMMMMMMMMMMMMMMMMMMMMMRRMMMMMMMMMMMMMMMMMMM
MMMMMMMMMMMMMMMMMMMMMMMMMMMMMMMMMMMRMMMMMMMMMMMMMMMMMMMMMMRRMMMMMMMMMMMMMMMMMMMM
MMMMMMMMMMMMMMMMMMMMMMMMMMMMMMMMMMMRRMMMMMMMMMMMMMMMMMMMMMRMMMMMMMMMMMMMRRRRRRRR
MMMMMMMMMMMMMMMMMMMMMMMMMMMMMMRRRRRRRRRRRRRRRRRRMMMMMMMMMMRMMMMMMMMMMMRRRMMMMMMM
MMMMMMMMMMMMMMMMMMMMMMMMMMMMRRRMMMMMRMMMMMMMMMMRRRMMMMMMMMRMMMMMMMMMRRRMMMMMMMMM
MMMMMMMMMMMMMMMMMMMMMMMMMMMRRMMMMMMMRMMMMMMMMMMMMRRMMMMMMMRMMMMMMMRRMMMMMMMMMMMM
RRMMMMMMMMMMMMMMMMMMMMMMMMRRMMMMMMMMRMMMMMMMMMMMMMRRRMMMMMRRMMMMRRRMMMMMMMMMMMMM
MMRRRRRRRRRMMMMMMMMMMMMMMMRMMMMMMMMMRMMMMMMMMMMMMMMMRRRRRRRRRRRRRMMMMMMMMMMMMMMM
MMMMMMMMMMRRRRRMMMMMMMMMMRMMMMMMMMMMRMMMMMMMMMMMMMMMMMMMMMRRMMMMMMMMMMMMMMMMMMMM
MMMMMMMMMMMMMMRRRMMMMMMMMRMMMMMMMMMRRRRRRRRRRRRRRRRRRRRRRRRMMMMMMMMMMMMMMMMMMMMM
MMMMMMMMMMMMMMMMRRRRRMMMRRMMMMMMMMRRMMMMMMMMMMMMMMMMMMMMMMMMMMMMMMMMMMMMMMMMMMMM
MMMMMMMMMMMMMMMMMMMMRRRRRRRRRRRRRRMMMMMMMMMMMMMMMMMMMMMMMMMMMMMMMMMMMMMMMMMMMMMM
MMMMMMMMMMMMMMMMMMMMMMMRRMMMMMMMMMMMMMMMMMMMMMMMMRRRRRRRRRRRMMMMMMMMMMMMMMMMMMMM
RRMMMMMMMMMMMMMMMMMMMMMRMMMMMMMMMMMMMMMMMMMMMMRRRRMMMMMMMMMRRRRMMMMMMMMMMMMMMMMM
MMRRRRRRRRMMMMMMMMMMMMRRMMMMMMMMMMMMMMMMMMMRRRMMMMMMMMMMMMMMMMRRRMMMMMMMMMMMMMMM
MMMMMMMMMRRRRMMMMMMMMMRMMMMMMMMMMMMMMMMMMMRRMMMMMMMMMMMMMMMMMMMRRMMMMMMMMMMMMMMM
MMMMMMMMMMMMMRRRRRMMMMRMMMMMMMMMMMMMMMMMRRMMMMMMMMMMMMMMMMMMMMMMRRMMMMMMMMMMMMMM
MMMMMMMMMMMMMMMMMRRRRRRMMMMMMMMMMMMMMMRRRMMMMMMMMMMMMMMMMMMMMMMMMRRMMMMMMRRRRRRR
MMMMMMMMMMMMMMMMMMMMMRRRRRMMMMMMMMMMMRRMMMMMMMMMMMMMMMMMMMMMMMRRRRRRRRRRRRMMMMMM
MMMMMMMMMMMMMMMMMMMMMRMMMMRRRMMMMMMRRRMMMMMMMMMMMMMMMMMMMRRRRRRMMMRRMMMMMMMMMMMM
MMMMMMMMMMMMMMMMMMMMRRMMMMMMRRRMMMRRMMMMMMMMMMMMMMMMMMRRRRMMMMMMMMMRMMMMMMMMMMMM
MMMMMMMMMMMMMMMMMMMRRMMMMMMMMMRRRRRMMMMMMMMMMMMMMMMMRRRMMMMMMMMMMMMRRMMMMMMMMMMM
MMMMMMMMMMMMMMMMMMRRMMMMMMMMMMMRRRMMMMMMMMMMMMMMMMMRRMMMMMMMMMMMMMMMRMMMMMMMMMMM
MMMMMMMMMMMMMMMMMMRMMMMMMMMMMMMRMRRMMMMMMMMMMMMMMMRRMMMMMMMMMMMMMMMMRMMMMMMMMMMM
MMMMMMMMMMMMMMMMMRRMMMMMMMMMMMRRMMRRRMMMMMMMMMMMMMRMMMMMMMMMMMMMMMMMRRMMMMMMMMMM
RRRRRMMMMMMMMMMMRRMMMMMMMMMMMMRMMMMMRRMMMMMMMMMMMMRMMMMMMMMMMMMMMMMMMRMMMMMMMMMM
MMMMRRRMMMMMMMMRRMMMMMMMMMMMMRMMMMMMMRRMMMMMMMMMMMRMMMMMMMMMMMMMMMMMMRMMMMMMMMMM
MMMMMMRRRMMMMMRRMMMMMMMMMMMMMRMMMMMMMMRRMMMMMMMMMMRRRMMMMMMMMMMMMMMMMRMMMMMMMMMM
MMMMMMMMRRRRRRRMMMMMMMMMMMMMRRMMMMMMMMMRMMMMMMMMMMMMRRMMMMMMMMMMMMMMMRRMMMMRRRRR
MMMMMMMMMMMRRRRRRMMMMMMMMMMRRMMMMMMMMMMRMMMMMMMMMMMMMMRRMMMMMMMMMMMMMMRRRRRRMMMM
MMMMMMMMMRRRMMMMRRRMMMMMMMMRMMMMMMMMMMMRMMMMMMMMMMMMMMMRRMMMMMMMMMMRRRRMMMMMMMMM
MMMMMMMMRRMMMMMMMMRRRMMMMMRMMMMMMMMMMMMRMMMMMMMMMMMMMMMMRRMMMMMMRRRRMMRMMMMMMMMM
MMMMMMMRRMMMMMMMMMMMRRRMMRRMMMMMMMMMMMMRMMMMMMMMMMMMMMMMMRRMMRRRMMMMMMRMMMMMMMMM
MMMMMMRRMMMMMMMMMMMMMMMRRRMMMMMMMMMMMMMRMMMMMMMMMMMMMMMMMMRRRRMMMMMMMMRRMMMMMMMM
MMMRRRRMMMMMMMMMMMMMMMRRMRRRMMMMMMMMMMRRMMMMMMMMMMMMMMMMMMRRRMMMMMMMMMMRMMMMMMMM
RRRRMMMMMMMMMMMMMMMMMRRMMMMRRRMMMMMMMRRMMMMMMMMMMMMMMMMMRRMMRRMMMMMMMMMRRMMMMMMM
MMMMMMMMMMMMMMMMMMMMRRMMMMMMMRRMMMMMRRMMMMMMMMMMMMMMMMMRRMMMMRRMMMMMMMMMRMMMMMMM
MMMMMMMMMMMMMMMMMMMRRMMMMMMMMMRRMMMMRMMMMMMMMMMMMMMMMMMRMMMMMMRRMMMMMMMMRRMMMMMM
MMMMMMMMMMMMMMMMMMRRMMMMMMMMMMMRRRMRRMMMMMMMMMMMMMMMMMRRMMMMMMMRRMMMMMMMMRRRMMMM
MMMMMMMMMMMMMMMMMRMMMMMMMMMMMMMMMRRRMMMMMMMMMMMMMMMMMMRMMMMMMMMMRRMMMMMMMMMRRRRR
MMMMMMMMMMMMMMMMRRMMMMMMMMMMMMMMMMMRRRRMMMMMMMMMMMMMMMRMMMMMMMMMMRMMMMMMMMMMMMMM
MMMMMMMMMMMMMMMMRMMMMMMMMMMMMMMMMMMMMMRRRRMMMMMMMMMMMRRMMMMMMMMMMRRMMMMMMMMMMMMM
MMMMMMMMMMMMMMMRRMMMMMMMMMMMMMMMMMMMMMMMMRRRRMMMMMMMMRMMMMMMMMMMMMRMMMMMMMMMMMMM
MMMMMMMMMMMMMMRRMMMMMMMMMMMMMMMMMMMMMMMMMMMMRRMMMMMRRMMMMMMMMMMMMMRMMMMMMMMMMMMM
RRRRRRRMMMMMMRRMMMMMMMMMMMMMMMMMMMMMMMMMMMMMMRRRRRRRMMMMMMMMMMMMMMRMMMMMMMMMMMMM
MMMMMMRRMMMMRRMMMMMMMMMMMMMMMMMMMMMMMMMMMMMRRRRRRMMMMMMMMMMMMMMMMMRMMMMMMMMMMMMM
MMMMMMMRRRRRRMMMMMMMMMMMMMMMMMMMMMMMMMMMMRRRMMMMMRRMMMMMMMMMMMMMMMRMMMMMMMMMMMMM
MMMMMMMMMRRMMMMMMMMMMMMMMMMMMMMMMMMMMMMMRMMMMMMMMMRRMMMMMMMMMMMMMRRMMMMMMMMMMMMM
MMMMMMMMRRRRMMMMMMMMMMMMMMMMMMMMMMMMMMMRRMMMMMMMMMMRRRMMMMMMMMMRRRMMMMMMMMMMMMMM
MMMMMMMMRMMRRRMMMMMMMMMMMMMMMMMMMMMMMMMRMMMMMMMMMMMMMRRRMMMMMRRRMMMMMMMMMMMMMMMM
MMMMMMMRRMMMMRRRRRRRMMMMMMMMMMMMMMMMMMRRMMMMMMMMMMMMMMMRRRRRRRMMMMMMMMMMMMMMMMMM
MMMMMMMRMMMMMMMMMMMRRRRMMMMMMMMMMMMMMRRMMMMMMMMMMMMMMMMMRRRRMMMMMMMMMMMMMMMMMMMM
MMMMMRRRMMMMMMMMMMMMMMRRRMMMMMMMMMMMRRMMMMMMMMMMMMMMMMRRRMMRRMMMMMMMMMMMMMMMMMMM
MMRRRRMMMMMMMMMMMMMMMMMMRRMMMMMMMRRRRMMMMMMMMMMMMMMMRRRMMMMMRRMMMMMMMMMMMMMMMMMM
RRRMMMMMMMMMMMMMMMMMMMMMMRRMMRRRRRMMMMMMMMMMMMMMMMRRRMMMMMMMMRRMMMMMMMMMMMMMMMMM
MMMMMMMMMMMMMMMMMMMMRRRRRRRRRRMMMMMMMMMMMMMMMMMMRRRMMMMMMMMMMMRMMMMMMMMMMMMMMMMM
MMMMMMMMMMMMMMMRRRRRRMMMMMMRRMMMMMMMMMMMMMMMMMRRRMMMMMMMMMMMMMRMMMMMMMMMMMMMRRRR
MMMMMMMMMMMMMRRRMMMMMMMMMMMMRRMMMMMMMMMMMMMMRRRMMMMMMMMMMMMMMMRMMMMMMMMMMRRRRMMM
MMMMMMMMMMMMRRMMMMMMMMMMMMMMMRMMMMMMMMMMMMRRRMMMMMMMMMMMMMMMMMRMMMMMMMMMRRMMMMMM
MMMMMMMMMMMMRMMMMMMMMMMMMMMMMRRMMMMMMMMRRRRMMMMMMMMMMMMMMMMMRRRMMMMMMMMMRMMMMMMM
MMMMMMMMMMMMRMMMMMMMMMMMMMMMMMRRMMMMMRRRMMMMMMMMMMMMMMMMMMRRRMRRMMMMMMMRMMMMMMMM
MMMMMMMMMMMRRMMMMMMMMMMMMMMMMMMRMRRRRRMMMMMMMMMMMMMMMMMMRRRMMMMRMMMMMMRRMMMMMMMM
MMMMMMMMMMMRMMMMMMMMMMMMMMMMMMMRRRMMMMMMMMMMMMMMMMMMMMMRRMMMMMMRMMMMMMRMMMMMMMMM
MMMMMMMMMMMRMMMMMMMMMMMMMMMMMMMRMMMMMMMMMMMMMMMMMMMMMMMRMMMMMMMRRMMMMRRMMMMMMMMM
MMMMMMMMMMMRMMMMMMMMMMMMMMMMMMRRMMMMMMMMMMMMMMMMMMMMMMRRMMMMMMMMRRRRRRMMMMMMMMMM
MMMMMMMMMMMRMMMMMMMMMMMMMMMMMMRMMMMMMMMMMMMMMMMMMMMMMMRMMMMMMMMMMMMMMMMMMMMMMMMM
MMMMMMMMMMMRMMMMMMMMMMMMMMMMMMRMMMMMMMMMMMMMMMMMMMMMMRRMMMMMMMMMMMMMMMMMMMMMMMMM