MMMMMMRMMM
MMMMMMRMMM
MMMMRRRRRR
RMMRMMRMMM
MRRMMMRMMM
MMRMMRMMMM
MMRRRMMMMM
MRMMMMMMMM
MRMMMMMMMM
MMRMMMMMMM