CCCCCCRCCC
CCCCCCRCCC
CCCCRRRRRR
RCCRCCRCCC
CRRCCCRCCC
CCRCCRCCCC
CCRRRCCCCC
CRCCCCCCCC
CRCCCCCCCC
CCRCCCCCCC