MMMMMMMMMMDMMMMMMMMMMMMMDDDDMMMMMMMMMMMDDMMMMMMMMMMMDDMMMMMMMMMM
MMMMMMMMMMRRMMMMMMMMMMMRRMMRMMMMMMMMMMMRMMMMMMMMMRRRRMMMMMMMMMMM
MMMMMMMMMMMRRRMMMMMMMMMRMMMRRMMMMMMMMMRRMMMMMMMRRRMMMMMMMMMMMMMM
MMMMMMMMMMMMMRMMMMMMMMRRMMMMRRRMMMMMMMRMMMMMMRRRMMMMMMMMMMMMMMMM
MMMMMMMMMMMMMMRMMMMMRRRMMMMMMMRRMMMMMMRMMMRRRRMMMMMMMMMMMMMMMMMM
MMMMMMMMMMMMMMRRRRRRRMMMMMMMMMMRMMRRRRRRRRRMMMMMMMMMMMMMMMMMMMMM
RRMMMMMMMMMMMMMRMMMMMMMMMMMMMRRRRRRMMRMMMMMMMMMMMMMMMMMMMMMMMMMM
MRRRRMMMMMMMMMMRRMMMMMMMMRRRRRMMMMMMMRMMMMMMMMMMMMMMMMMMMMMMMMMM
MMMMRRMMMMMMMMMMRRMMMRRRRRMMMMMMMMMMMRMMMMMMMMMMMMMMMMMMMMMMMMMM
MMMMMRRMMMMMRRRRRRRRRRMMMMMMMMMMMMMMMRMMMMMMMMMMMMMMMMMMMMMMMMMM
MMMMMMRMRRRRMMMMMMRRMMMMMMMMMMMMMMMMMRMMMMMMMMMMMMMMMMMMMMMMMMMM
MMMMRRRRRMMMMMMMMMMRRMMMMMMMMMMMMMMMMRMMMMMMMMMMMMMMMMMMMMRRRRRR
RRRRRMMRRMMMMMMMMMMMRRMMMMMMMMMMMMMMMRRMMMMMMMMRRRRRRRRRRRRMMMMM
MMMMMMMMRRMMMMMMMMMMMRRMMMMMMMMMMMMMMMRRRMRRRRRRMMMRRRRRRRRRMMMM
MMMMMMMMMRRMMMMMMMMMMMRRRMMMMMMMMMMMMMRRRRRRRRRRRRRRMMMMMMMRRMMM
MMMMMMMMMMRMMMMMMMMMMMMMRRMMMMMMMMMRRRRMMMMMMMMMMMMMMMMMMMMMRMMM
MMMMMMMMMMRMMMMMMMMMMMMMMRMMMMMMMRRRMMMMMMMMMMMMMMMMMMMMMMMRRMMM
MMMMMMMMMMRMMMMMMMMMMMMMMRRMMMMRRRMMMMMMMMMMMMMMMMMMMMMMMMMRMMMM
MMMMMMMMMMRMMMMMMMMMMMMMMMRRMRRRMMMMMMMMMMMMMMMMMMMMMMMRRRRRRRRR
MMMMMMMMMMRRMMMMMMMMMMMMMMMRRRMMMMMMMMMMMMMMMMMMMMMRRRRMMMMMMMMM
MMMMMMMMMMMRMMMMMMMMMMRRRRRRRRMMMMMMMMMMMMMMMMRRRRRRMMRRMMMMMMMM
MMMMMMMMMMRRMMMMMRRRRRRMMMMMMRRMMMMMMMMMMMMRRRRMMMMMMMMRMMMMMMMM
MMRRRRRRRMRMMMRRRRMMMMMMMMMMMMRRRMMMMMMMRRRRMMMMMMMMMMMRMMMMMMMM
RRMMMMMMRRRRRRRMMMMMMMMMMMMMMMMMRRRMMMRRRMMMMMMMMMMMMMMRMMMMMMMM
MMMMMMMMMMRRMMMMMMMMMMMMMMMMMMMMMMRRRRRMMMMMMMMMMMMMMMRRMMMMMMMM
MMMMMMMMMMMRRMMMMMMMMMMMMMMMMMMMMMMRRMMMMMMMMMMMMMMMMRRMMMMMMMMM
MMMMMMMMMMMMMRRRMMMMMMMMMMMMMMMMMMRRRRRMMMMMMMMMMMMMMRMMMMMMMMMM
MMMMMMMMMMMMMMMRRRRMMMMMMMMMMMMMMRRMMMRMMMMMMMMMMMMMRRMMMMMMMMMM
MMMMMMMMMMMMMMMMMMRRRRMMMMMMMMMMMRMMMMRRMMMMMMMMMMMRRMMMMMMMMMMM
MMMMMMMMMMMMMMMMMMMMMMRRRMMMMMMMRRMMMMMRRMMMMMMMMMRRMMMMMMMMMMMM
MMMMMMMMMMMMMMMMMMMMMMMMRRMMMMMRRMMMMMMMMRMMMMMMMRRMMMMMMMMMMMMM
MMMMMMMMMMMMMMMMMMMMMMMMMRRMMRRRMMMMMMMMMRRMMMMMRRMMMMMMMMMMMMMM
MMMMMMMMMMMMMMMMMMMMMRRRRRRRRRMMMMMMMMMMMMRMMMRRMMMMMMMMMMMMMMMM
MMMMMMMMMMMMMMMMMMRRRRMMMMRRRMMMMMMMMMMMMMRRRRRMMMMMMMMMMMMMMMMM
RRRRMMMMMMMMMMMMMRRMMMMMMMMMRRRMMMMMMMMMMMMRMMMMMMMMMMMMMMMMMMMM
MMMRRRRRMMMMMMMMRRMMMMMMMMMMMMRRMMMMMMMMMMMRRMMMMMMMMMMMMMMMMMMM
MMMMMMMRRRRRRMMMRMMMMMMMMMMMMMMRRMMMMMMMMMMMRRMMMMMMMMMMMMMMMMMM
MMMMMMMMMMMMMRRRRRRMMMMMMMMMMMMMRMMMMMMMMMMMMRRMMMMMMMMMMRRRRRRR
MMMMMMMMMMMMMMMMMMRRRMMMMMMMMMMMRMMMMMMMMMMMMMRRMMMMMMRRRRMMMMMM
MMMMMMMMMMMMMMMMMMMMRRRMMMMMMMMMRMMMRRRRRRRRRRRRRRRRRRRMMMMMMMMM
MMMMMMMMMMMMMMMMMMMMMMRRMMMMMMRRRRRRRMMMMMMMMMMRRMMMMMMMMMMMMMMM
MMMMMMMMMMMMMMMMMMMMMMMRRMMMRRRMMMMMMMMMMMMMMMMMRRMMMMMMMMMRRRRR
MMMMMMMMMMMMMMMMMMMMMMMMRRRRRMMMMMMMMMMMMMMMMMMMMRRMMMMMMRRRMMMM
MMMMMMMMMMMMMMMMMMMMMMMMRRRRMMMMMMMMMMMMMMMMMMMMMMRRMMRRRMMMMMMM
MMMMMMMMMMMMMMMMMMMMMMMRRMMRRRMMMMMMMMMMMMMMMMMMMMMRRRRMMMMMMMMM
MMMMMMMMMMMMMMMMMMMMMMRRMMMMMRRRMMMMMMMMMMMMMMMMMRRRRRRMMMMMMMMM
MMMMMMMMMMMMMMMMMMMMMRRMMMMMMMMRRRMMMMMMMMMMMMRRRRMMMMRRMMMMMMMM
MMMMMMMMMMMMMMMMMMMMRRMMMMMMMMMMMRRRMMMMMMMRRRRMMMMMMMMRRRMMMMRR
MMMMMMMMMMMMMMMMMMRRRMMMMMMMMMMMMMMRRMMMMRRRMMMMMMMMMMMMMRRRRRRM
RRRRMMMMMMMMMMMMMRRMMMMMMMMMMMMMMMMMRRMMRRMMMMMMMMMMMMMMMMRRMMMM
MMMRRRRRMMMMMMMRRRMMMMMMMMMMMMMMMMMMMRRRRMMMMMMMMMMMMMMMMMMMMMMM
MMMMMMMRRRMMMRRRMMMMMMMMMMMMMMMMMMMMMMRRMMMMMMMMMMMMMMMMMMMMMMMM
MMMMMMMMMMRRRRMMMMMMMMMMMMMMMMMMMMMMMRRRRMMMMMMMMMMMMMMMMMMMMMMM
MMMMMMMMMMRRRRMMMMMMMMMMMMMMRRMMMMMMRRMMRMMMMMMMMMMMMMMMMMMMMMMM
MMMMMMMMMMRMMRRMMMMMMMMMMMMRRRRRMMMRRMMMRRMMMMMMMMMMMMMMMMMMMMMM
MMMMMMMMMMRMMMRMMMMMMRRRRRRRMMMMRRRRMMMMMRRRMMMMMMMMMMMMMMMMMMMM
MMMMMMMMMRRMMMMRRMMMRRMMMMMMMMMMMMMMMMMMMRMMRRRRMMMMMMMMMMMMMMMM
MMMMMMMMMRMMMMMMRRRRRMMMMMMMMMMMMMMMMMMMMRMMMMMRRRMMMMMMMMMMMMMM
MMMMMMMMMRMMMMMMMMMMMMMMMMMMMMMMMMMMMMMMMRMMMMMMMRRMMMMMMMMMMMMM
MMMMMMMMMRMMMMMMMMMMMMMMMMMMMMMMMMMMMMMMMRMMMMMMMMRRMMMMMMMMMMMM
MMMMMMMMMRMMMMMMMMMMMMMMMMMMMMMMMMMMMMMMMRMMMMMMMMMMRRMMMMMMMMMM
MMMMMMMMMRMMMMMMMMMMMMMMMMMMMMMMMMMMMMMMMRMMMMMMMMMMMRRMMMMMMMMM
MMMMMMMMMRMMMMMMMMMMMMMMMMMMMMMMMMMMMMMMRRMMMMMMMMMMMMRRRRRMMMMM
MMMMMMMMMRMMMMMMMMMMMMMMMMMMMMMMMMMMMMMMRMMMMMMMMMMMMMMMMMRRRRMM