MMMMMDMMMMDDDMMMMDMMMMMMMMMMMMMMMMMMMMMMMMMDDMMMDMMMMDDMMMMMMMMM
MMMMMRMMMMMMRRRRMRMMMMMMMMMMMMMMMMMMMMMMMMMRMMMMRMMMMMRMMMMMMMMM
MMMMMRRMMMMMMMMRRRRRRRRRMMMMMMMMMMMMMMMMMMRRMMMMRMMMMMRMMMMMMMMM
MMMMMMRRMMMMMMMMMRRMMMMRRRRRRRMMMMMMMMMMRRRMMMMMRMMMMMRRMMMMMMMM
MMMMMMMRRRMMMMMMMMRRMMMMMMMMMRRRRRMMMMRRRMMMMMMMRMMMMMMRMMMMMMMM
MMMMMMMMMRRRMMMMMMMRRMMMMMMMMMMMMRRRRRRRMMMMMMMMRMMMMMRRMMMMMMMM
MMMMMMMMMMMRRRMMMMMMRRRMMMMMMMMMMMMMRRMRRRRRMMMMRMMMMMRMMMMMMMMM
MMMMMMMMMMMMMRRRRMMMMMRRMMMMMMMMMMMMRMMMMMMRRRRRRMMMMMRMMMMMMMMM
MMMMMMMMMMMMMMMMRRRRRRRRRMMMMMMMMMMMRMMMMMMMMMRRRRMMMMRMMMMMMMMM
MMMMMMMMMMMMMMMMMMMMMMRRRRRRRRRMMMMMRMMMMMMMMMMRMMRRRRRMMMMMMMMM
MMMMMMMMMMMMMMMMMMMMMMMMMRMMMMRRRRRMRMMMMMMMMMMRMMMMMRRRRRRRRRMM
MMMMMMMMMMMMMMMMMMMMMMMMMRMMMMMMMMRRRRRMMMMMMMMRMMMMMRMMMMMMMRRR
MMMMMMMMMMMMMMMMMMMMMMMMRRMMMMMMMMMRMMMRRMMMMMMRMMMMRRMMMMMMMMMM
RRMMMMMMMMMMMMMMMMMMMMRRRMMMMMMMMMMRMMMMRRRRMMMRMMMMRMMMMMMMMMMM
MRRRRRRMMMMMMMMMRRRRRRRMMMMMMMMMMMRRMMMMMMMMRRRRRRRMRMMMMMMMRRRR
MMMMMMRRRRMMMRRRRMMMMMMMMMMMMMMMMMRMMMMMMMMMMMRMMMRRRRRRRRRRRMMM
MMMMMMMMMRRRRRMMMMMMMMMMMMMMMMMMMRRMMMMMMMMMMMRMMMMMRMMMMMMMMMMM
MMMMMMMMMMMMRRRMMMMMMMMMMMMMMMMMMRMMMMMMMMMMMRRMMMMMRRMMMMMMMMMM
MMMMMMMMMMMMMMRRRMMMMMMMMMMMMMMMRRMMMMMMMMMMRRMMMMMMMRRMMMMMMMMM
MMMMMMMMMMMMMMMMRRRMMMMMMMMMMMMRRMMMMMMMMMMRRMMMMMMMMMRMMMMMMMMM
MMMMMMMMMMMMMMMMMMRRRMMMMMMMMRRRMMMMMMMMMMRRMMMMMMMMMMRRMMRRRRRR
MMMMMMMMMMMMMMMMMMMMRRMMMMMRRRMMMMMMMMMMRRRMMMMMMMMMMMMRRRRMMMMM
MMMMMMMMMMMMMMMMMMMRRRRRRRRRMMMMMMMMMMRRRMMMMMMMMMMMMRRRRRMMMMMM
MMMMMMMMMMMMMMMRRRRMMMRRMMMMMMMMMMMMMRRMMMMMMMMMMMRRRMMMMRRMMMMM
MMMMMMMMMMMRRRRMMMMMMMMRRRRRRRRRRRRRRRRRRRRMMMRRRRRMMMMMMMRRMMMM
MMMMMMMMMRRRMMMMMMMMMMMMMMMMMMMMMMRRMMMMMMRRRRRMMMMMMMMMMMMRMMMM
MMMMMMMMRRMMMMMMMMMMMMMMMMMMMMMMMRRMMMMMMMRRRRRRRMMMMMMMMMMRMMMM
MMMMMMMRRMMMMMMMMMMMMMMMMMMMMMMMRRMMMMMMMRRMMMMMRRMMMMMMMMMRMMMM
MMMMMMMRMMMMMMMMMMMMMMMMMMMMMMRRRMMMMMMRRRMMMMMMMRRMMMMMMMRRMMMM
RRRRRRRRRRRRRRRRRRMMMMMMMMMMMRRMMMMMMMRRMMMMMMMMMMRRMMMMMMRMMMMM
MMMMMMRMMMMMMMMMMRRRRRMMMMMRRRMMMMMMMMRMMMMMMMMMMMMRRMMMMRRMMMMM
MMMMMMRMMMMMMMMMMMMMMMRRRMRRMMMMMMMMMRRMMMMMMMMMMMMMRMMMRRMMMMMM
MMMMMMRMMMMMMMMMMMMMMMMMRRRRMMMMMMMMRRMMMMMMMMMMMMMMMRRRRMMMMMMM
MMMMMMRMMMMMMMMMMMMMMMMMMRRRRRRRRMMRRMMMMMMMMMMMMMMMMMRRMMMMMMMM
MMMMMMRRMMMMMMMMMMMMMMMRRRMMMMMMRRRRRRRRMMMMMMMMMMMMMMRRRMMMMMMM
MMMMMMMRRMMMMMMMMMMMMMRRMMMMMMMMMMRMMMMRRRRMMMMMMMMMMMRMRRMMMMMM
MMMMMMMMRRMMMMMMMMRRRRRMMMMMMMMMMMRMMMMMMMRRMMMMMMMMMMRMMRRRRMMM
MMMMMMMMMRRRMMMMMRRMMMMMMMMMMMMMMMRMMMMMMMMRRMMMMMMMMMRMMMMMRRRR
MMMMMMMMMMMRRRMMRRMMMMMMMMMMMMMMMRRMMMMMMMMMRRMMMMMMMMRMMMMMMMMM
MMMMMMMMMMMMMRRRRRRMMMMMMMMMMMMMMRMMMMMMMMMMMRMMMMMMMMRMMMMMMMMM
MMMMMMMMMMMMMMRRMMRRRRRRRRRRRRRMMRMMMMMMMMMMMRRRMMMMMMRMMMMMMMMM
MMMMMMMMMRRRRRRMMMMMMMMMMMMMMMRRRRRRMMMMMMMMMMMRRMMMMMRMMMMMMMMM
RRRRRRRRRRMMMMMMMMMMMMMMMMMMMMMMMRMRRRRMMMMMMMMMRRRMMMRMMMMMMMMM
MMMMMMMMMMMMMMMMMMMMMMMMMMMMMMMMRRMMMMRRMMMMMMMMMMRMMMRMMMMMMMMM
MMMMMMMMMMMMMMMMMMMMMMMMMMMMMMMRRMMMMMMRMMMMMMMMMMMRMMRMMMMMMMMM
MMMMMMMMMMMMMMMMMMMMMMMMMMMMMMRRMMMMMMMRRMMMMMMMMMMRMRRMMMMMMMMM
MMMMMMMMMMMMMMMMMMMMMMMMMMMMMRRMMMMMMMMMRMMMMMMMMMMRRRMMMMMMMMMM
RRMMMMMMMMMMMMMMMMMMMMMMMMMMRRMMMMMMMMMMRMMMMMMMMMMMRMMMMMMMMMMM
MRRRMMMMMMMMMMMMMMMMMMMMMRRRMMMMMMMMMMMMRRMMMMMMMMMMRRMMMMMMMMMM
MMMRRRRMMMMMMMMMMMMMMRRRRRMMMMMMMMMMMMMMRRMMMMMMMMMRRRRMMMMMMMMM
MMMMMMRRRRRMMMMMMMRRRRMMMMMMMMMMMMMMMMMMRMMMMMMMMMMRMMRRMMMMMMMM
MMMMMMMMMMRRRRMMRRRMMMMMMMMMMMMMMMMMMMMMRMMMMMMMMMRRMMMRRMMMMMMM
MMMMMMMMMMMMMRRRRRRRMMMMMMMMMMMMMMMMMMMRRMMMMMMMRRRMMMMMRRMMMMMM
MMMMMMMMMMMMMRRMMMMRRRRRRMMMMMMMMMMMMMMRMMMMMRRRRMMMMMMMMRMMMMMM
MMMMMMMMMMMRRRMMMMMMMMMMMRRRRRRRRRRRRRRRRRRRRRMMMMMMMMMMMRRMMMMM
MMMMMMMMMMRRMMMMMMMMMMMMMMMMMMMMMMMMMMRRMMMMMMMMMMMMMMMMMMRMMMMM
MMMMMMMMRRRMMMMMMMMMMMMMMMMMMMMMMMMMMMRMMMMMMMMMMMMMMMMMMMRMMMMM
MMMMMMRRRMMMMMMMMMMMMMMMMMMMMMMMMMMMMRRMMMMMMMMMMMMMMMMMMRRMMMMM
MMMMMMRMMMMMMMMMMMMMMMMMMMMMMMMMMMMMRMMMMMMMMMMMMMMMMMMMMRMMMMMM
MMMMMMRMMMMMMMMMMMMMMMMMMMMMMMMMMMMRRMMMMMMMMMMMMMMMMMMMMRMMMMMM
MMMMMMRMMMMMMMMMMMMMMMMMMMMMMMMMMMRRMMMMMMMMMMMMMMMMMMMMMRMMMMMM
MMMMMMRMMMMMMMMMMMMMMMMMMMMMMMMMMRRMMMMMMMMMMMMMMMMMMMMMMRMMMMMM
MMMMMMRMMMMMMMMMMMMMMMMMMMMMMMMMRRMMMMMMMMMMMMMMMMMMMMMMMRMMMMMM
MMMMMMRMMMMMMMMMMMMMMMMMMMMMMMMRRMMMMMMMMMMMMMMMMMMMMMMMMRRMMMMM